#From https://devcentral.f5.com/wiki/iRules.Events.ashx
ACCESS	ACCESS_ACL_ALLOWED, ACCESS_ACL_DENIED, ACCESS_POLICY_AGENT_EVENT, ACCESS_POLICY_COMPLETED, ACCESS_SESSION_CLOSED, ACCESS_SESSION_STARTED
APM	ACCESS_ACL_ALLOWED, ACCESS_ACL_DENIED, ACCESS_POLICY_AGENT_EVENT, ACCESS_POLICY_COMPLETED, ACCESS_SESSION_CLOSED, ACCESS_SESSION_STARTED
ASM	ASM_REQUEST_BLOCKING, ASM_REQUEST_VIOLATION, ASM_RESPONSE_VIOLATION
AUTH	AUTH_ERROR, AUTH_FAILURE, AUTH_RESULT, AUTH_SUCCESS, AUTH_WANTCREDENTIAL
CACHE	CACHE_REQUEST, CACHE_RESPONSE, CACHE_UPDATE
DIAMETER	DIAMETER_INGRESS, DIAMETER_EGRESS
DNS	DNS_REQUEST, DNS_RESPONSE
GLOBAL	LB_FAILED, LB_SELECTED, NAME_RESOLVED, PERSIST_DOWN, RULE_INIT
GTM	DNS_REQUEST, DNS_RESPONSE, LB_FAILED, LB_SELECTED, RULE_INIT
HTTP session	HTTP_CLASS_FAILED, HTTP_CLASS_SELECTED, HTTP_REQUEST, HTTP_REQUEST_DATA, HTTP_REQUEST_SEND, HTTP_RESPONSE, HTTP_RESPONSE_CONTINUE, HTTP_RESPONSE_DATA, HTTP_REQUEST_RELEASE, HTTP_RESPONSE_RELEASE
IP	CLIENT_ACCEPTED, CLIENT_CLOSED, CLIENT_DATA, CLIENTSSL_DATA, SERVER_CLOSED, SERVER_CONNECTED, SERVER_DATA, SERVERSSL_DATA
LB	LB_FAILED, LB_SELECTED, LB_QUEUED
NAME	NAME_RESOLVED
REWRITE	REWRITE_REQUEST_DONE, REWRITE_RESPONSE_DONE
RTSP	RTSP_REQUEST, RTSP_REQUEST_DATA, RTSP_RESPONSE, RTSP_RESPONSE_DATA
SCTP	CLIENT_ACCEPTED, CLIENT_CLOSED, CLIENT_DATA, CLIENTSSL_DATA, SERVER_CLOSED, SERVER_CONNECTED, SERVER_DATA, SERVERSSL_DATA
SIP	SIP_REQUEST, SIP_REQUEST_SEND, SIP_RESPONSE, SIP_RESPONSE_SEND
SSL	CLIENTSSL_CLIENTCERT, CLIENTSSL_CLIENTHELLO, CLIENTSSL_DATA, CLIENTSSL_HANDSHAKE, SERVERSSL_CLIENTHELLO_SEND, SERVERSSL_DATA, SERVERSSL_HANDSHAKE, SERVERSSL_SERVERHELLO
STREAM	STREAM_MATCHED
TCP	CLIENT_ACCEPTED, CLIENT_CLOSED, CLIENT_DATA, CLIENTSSL_DATA, SERVER_CLOSED, SERVER_CONNECTED, SERVER_DATA, SERVERSSL_DATA, USER_REQUEST, USER_RESPONSE
UDP	CLIENT_ACCEPTED, CLIENT_CLOSED, CLIENT_DATA, SERVER_CLOSED, SERVER_CONNECTED, SERVER_DATA
XML	XML_BEGIN_DOCUMENT, XML_BEGIN_ELEMENT, XML_CDATA, XML_CONTENT_BASED_ROUTING, XML_END_ELEMENT, XML_EVENT